
_____________________ 1 _____________________



_____________________ 2 _____________________



_____________________ 3 _____________________



_____________________ 4 _____________________



_____________________ 5 _____________________



_____________________ 6 _____________________



_____________________ 7 _____________________



_____________________ 8 _____________________



_____________________ 9 _____________________



_____________________ 10 _____________________



_____________________ 11 _____________________



_____________________ 12 _____________________



_____________________ 13 _____________________



_____________________ 14 _____________________



_____________________ 15 _____________________



_____________________ 16 _____________________



_____________________ 17 _____________________



_____________________ 18 _____________________



_____________________ 19 _____________________



_____________________ 20 _____________________



_____________________ 21 _____________________



_____________________ 22 _____________________



_____________________ 23 _____________________



_____________________ 24 _____________________



_____________________ 25 _____________________



_____________________ 26 _____________________



_____________________ 27 _____________________



_____________________ 28 _____________________



_____________________ 29 _____________________



_____________________ 30 _____________________



_____________________ 31 _____________________



_____________________ 32 _____________________



_____________________ 33 _____________________



_____________________ 34 _____________________



_____________________ 35 _____________________



_____________________ 36 _____________________



_____________________ 37 _____________________



_____________________ 38 _____________________



_____________________ 39 _____________________



_____________________ 40 _____________________




